##################################################
#           ###             #           ##########
###### ###########                   #####       #
#              ############      #############   #
#                                                #
################            ######################
#                 #####                          #
#############     #####         ##################
#######       ####            #                  #
##################################################
